"","top100_repository_name","month","monthly_increase","monthly_begin_at","monthly_end_with"
"1","Bukkit","2012-03",9,431,440
"2","Bukkit","2012-04",19,438,457
"3","Bukkit","2012-05",19,455,474
"4","Bukkit","2012-06",18,475,493
"5","Bukkit","2012-07",15,492,507
"6","Bukkit","2012-08",50,506,556
"7","Bukkit","2012-09",19,555,574
"8","Bukkit","2012-10",26,573,599
"9","Bukkit","2012-11",21,600,621
"10","Bukkit","2012-12",21,621,642
"11","CodeIgniter","2012-03",55,708,763
"12","CodeIgniter","2012-04",75,763,838
"13","CodeIgniter","2012-05",92,837,929
"14","CodeIgniter","2012-06",99,929,1028
"15","CodeIgniter","2012-07",140,1028,1168
"16","CodeIgniter","2012-08",94,1168,1262
"17","CodeIgniter","2012-09",91,1262,1353
"18","CodeIgniter","2012-10",91,1352,1443
"19","CodeIgniter","2012-11",103,1441,1544
"20","CodeIgniter","2012-12",72,1544,1616
"21","CraftBukkit","2012-03",22,528,550
"22","CraftBukkit","2012-04",24,547,571
"23","CraftBukkit","2012-05",27,569,596
"24","CraftBukkit","2012-06",33,594,627
"25","CraftBukkit","2012-07",630,11,641
"26","CraftBukkit","2012-08",701,13,714
"27","CraftBukkit","2012-09",724,19,743
"28","CraftBukkit","2012-10",762,23,785
"29","CraftBukkit","2012-11",796,24,820
"30","CraftBukkit","2012-12",835,25,860
"31","Modernizr","2012-03",24,379,403
"32","Modernizr","2012-04",38,403,441
"33","Modernizr","2012-05",37,441,478
"34","Modernizr","2012-06",45,478,523
"35","Modernizr","2012-07",31,523,554
"36","Modernizr","2012-08",50,554,604
"37","Modernizr","2012-09",28,604,632
"38","Modernizr","2012-10",46,632,678
"39","Modernizr","2012-11",62,678,740
"40","Modernizr","2012-12",15,740,755
"41","RestKit","2012-03",34,342,376
"42","RestKit","2012-04",44,376,420
"43","RestKit","2012-05",47,420,467
"44","RestKit","2012-06",38,467,505
"45","RestKit","2012-07",57,505,562
"46","RestKit","2012-08",56,563,619
"47","RestKit","2012-09",56,620,676
"48","RestKit","2012-10",51,674,725
"49","RestKit","2012-11",55,726,781
"50","RestKit","2012-12",23,781,804
"51","Sick-Beard","2012-03",475,11,486
"52","Sick-Beard","2012-04",510,11,521
"53","Sick-Beard","2012-05",541,11,552
"54","Sick-Beard","2012-06",550,11,561
"55","Sick-Beard","2012-07",580,13,593
"56","Sick-Beard","2012-08",599,13,612
"57","Sick-Beard","2012-09",634,11,645
"58","Sick-Beard","2012-10",692,11,703
"59","Sick-Beard","2012-11",740,11,751
"60","Sick-Beard","2012-12",766,16,782
"61","Spoon-Knife","2012-03",6695,18,6713
"62","Spoon-Knife","2012-04",7344,18,7362
"63","Spoon-Knife","2012-05",8009,22,8031
"64","Spoon-Knife","2012-06",8365,23,8388
"65","Spoon-Knife","2012-07",8769,24,8793
"66","Spoon-Knife","2012-08",427,8793,9220
"67","Spoon-Knife","2012-09",486,9219,9705
"68","Spoon-Knife","2012-10",10182,23,10205
"69","Spoon-Knife","2012-11",10622,23,10645
"70","Spoon-Knife","2012-12",10844,25,10869
"71","TrinityCore","2012-03",822,14,836
"72","TrinityCore","2012-04",868,15,883
"73","TrinityCore","2012-05",907,17,924
"74","TrinityCore","2012-06",946,17,963
"75","TrinityCore","2012-07",1001,17,1018
"76","TrinityCore","2012-08",1115,17,1132
"77","TrinityCore","2012-09",69,1132,1201
"78","TrinityCore","2012-10",59,1202,1261
"79","TrinityCore","2012-11",67,1261,1328
"80","TrinityCore","2012-12",48,1328,1376
"81","ace","2012-03",600,12,612
"82","ace","2012-04",626,12,638
"83","ace","2012-05",640,12,652
"84","ace","2012-06",665,12,677
"85","ace","2012-07",694,12,706
"86","ace","2012-08",718,12,730
"87","ace","2012-09",769,13,782
"88","ace","2012-10",807,13,820
"89","ace","2012-11",840,14,854
"90","ace","2012-12",872,15,887
"91","active_admin","2012-03",27,569,596
"92","active_admin","2012-04",47,596,643
"93","active_admin","2012-05",29,642,671
"94","active_admin","2012-06",64,671,735
"95","active_admin","2012-07",102,735,837
"96","active_admin","2012-08",30,836,866
"97","active_admin","2012-09",39,866,905
"98","active_admin","2012-10",32,905,937
"99","active_admin","2012-11",34,937,971
"100","active_admin","2012-12",16,970,986
"101","active_merchant","2012-03",805,11,816
"102","active_merchant","2012-04",20,816,836
"103","active_merchant","2012-05",22,835,857
"104","active_merchant","2012-06",861,15,876
"105","active_merchant","2012-07",890,16,906
"106","active_merchant","2012-08",916,16,932
"107","active_merchant","2012-09",22,932,954
"108","active_merchant","2012-10",968,17,985
"109","active_merchant","2012-11",1001,15,1016
"110","active_merchant","2012-12",15,1016,1031
"111","asi-http-request","2012-03",22,492,514
"112","asi-http-request","2012-04",31,513,544
"113","asi-http-request","2012-05",25,543,568
"114","asi-http-request","2012-06",31,568,599
"115","asi-http-request","2012-07",49,598,647
"116","asi-http-request","2012-08",29,647,676
"117","asi-http-request","2012-09",34,676,710
"118","asi-http-request","2012-10",41,710,751
"119","asi-http-request","2012-11",32,751,783
"120","asi-http-request","2012-12",16,783,799
"121","authlogic","2012-03",417,19,436
"122","authlogic","2012-04",422,20,442
"123","authlogic","2012-05",426,20,446
"124","authlogic","2012-06",12,443,455
"125","authlogic","2012-07",5,454,459
"126","authlogic","2012-08",3,456,459
"127","authlogic","2012-09",3,456,459
"128","authlogic","2012-10",4,453,457
"129","authlogic","2012-11",2,451,453
"130","authlogic","2012-12",4,453,457
"131","backbone","2012-03",950,11,961
"132","backbone","2012-04",1036,12,1048
"133","backbone","2012-05",1127,14,1141
"134","backbone","2012-06",1219,18,1237
"135","backbone","2012-07",1322,24,1346
"136","backbone","2012-08",1474,27,1501
"137","backbone","2012-09",1581,34,1615
"138","backbone","2012-10",1710,36,1746
"139","backbone","2012-11",1842,40,1882
"140","backbone","2012-12",1918,44,1962
"141","bitcoin","2012-03",8,373,381
"142","bitcoin","2012-04",11,381,392
"143","bitcoin","2012-05",5,391,396
"144","bitcoin","2012-06",19,394,413
"145","bitcoin","2012-07",14,413,427
"146","bitcoin","2012-08",14,422,436
"147","bitcoin","2012-09",23,436,459
"148","bitcoin","2012-10",11,459,470
"149","bitcoin","2012-11",27,469,496
"150","bitcoin","2012-12",17,496,513
"151","blueprint-css","2012-03",3,428,431
"152","blueprint-css","2012-04",8,431,439
"153","blueprint-css","2012-05",1,438,439
"154","blueprint-css","2012-06",13,437,450
"155","blueprint-css","2012-07",3,450,453
"156","blueprint-css","2012-08",13,452,465
"157","blueprint-css","2012-09",7,464,471
"158","blueprint-css","2012-10",11,470,481
"159","blueprint-css","2012-11",4,480,484
"160","blueprint-css","2012-12",1,480,481
"161","bootstrap","2012-03",472,4335,4807
"162","bootstrap","2012-04",566,4807,5373
"163","bootstrap","2012-05",568,5372,5940
"164","bootstrap","2012-06",6504,11,6515
"165","bootstrap","2012-07",7081,38,7119
"166","bootstrap","2012-08",8026,11,8037
"167","bootstrap","2012-09",8872,11,8883
"168","bootstrap","2012-10",9637,11,9648
"169","bootstrap","2012-11",10363,11,10374
"170","bootstrap","2012-12",10752,12,10764
"171","bundler","2012-03",356,35,391
"172","bundler","2012-04",379,35,414
"173","bundler","2012-05",27,414,441
"174","bundler","2012-06",8,440,448
"175","bundler","2012-07",17,448,465
"176","bundler","2012-08",442,35,477
"177","bundler","2012-09",29,476,505
"178","bundler","2012-10",11,506,517
"179","bundler","2012-11",20,517,537
"180","bundler","2012-12",518,30,548
"181","cakephp","2012-03",37,608,645
"182","cakephp","2012-04",36,645,681
"183","cakephp","2012-05",35,681,716
"184","cakephp","2012-06",24,715,739
"185","cakephp","2012-07",52,738,790
"186","cakephp","2012-08",53,790,843
"187","cakephp","2012-09",48,844,892
"188","cakephp","2012-10",41,892,933
"189","cakephp","2012-11",43,933,976
"190","cakephp","2012-12",39,976,1015
"191","capybara","2012-03",6,366,372
"192","capybara","2012-04",9,372,381
"193","capybara","2012-05",9,381,390
"194","capybara","2012-06",22,390,412
"195","capybara","2012-07",27,411,438
"196","capybara","2012-08",11,438,449
"197","capybara","2012-09",19,449,468
"198","capybara","2012-10",18,468,486
"199","capybara","2012-11",23,486,509
"200","capybara","2012-12",21,509,530
"201","chef","2012-03",16,468,484
"202","chef","2012-04",18,484,502
"203","chef","2012-05",17,502,519
"204","chef","2012-06",23,519,542
"205","chef","2012-07",16,542,558
"206","chef","2012-08",36,558,594
"207","chef","2012-09",20,592,612
"208","chef","2012-10",24,611,635
"209","chef","2012-11",26,635,661
"210","chef","2012-12",12,661,673
"211","chosen","2012-03",39,495,534
"212","chosen","2012-04",58,534,592
"213","chosen","2012-05",57,592,649
"214","chosen","2012-06",775,11,786
"215","chosen","2012-07",872,13,885
"216","chosen","2012-08",990,11,1001
"217","chosen","2012-09",1093,15,1108
"218","chosen","2012-10",1208,15,1223
"219","chosen","2012-11",1315,16,1331
"220","chosen","2012-12",1364,16,1380
"221","cloud9","2012-03",16,529,545
"222","cloud9","2012-04",25,545,570
"223","cloud9","2012-05",25,570,595
"224","cloud9","2012-06",44,593,637
"225","cloud9","2012-07",27,636,663
"226","cloud9","2012-08",29,663,692
"227","cloud9","2012-09",9,689,698
"228","cloud9","2012-10",17,695,712
"229","cloud9","2012-11",30,712,742
"230","cloud9","2012-12",13,743,756
"231","coffee-script","2012-03",414,15,429
"232","coffee-script","2012-04",440,16,456
"233","coffee-script","2012-05",464,15,479
"234","coffee-script","2012-06",487,16,503
"235","coffee-script","2012-07",519,18,537
"236","coffee-script","2012-08",558,18,576
"237","coffee-script","2012-09",578,20,598
"238","coffee-script","2012-10",605,20,625
"239","coffee-script","2012-11",634,20,654
"240","coffee-script","2012-12",662,20,682
"241","compass","2012-03",13,368,381
"242","compass","2012-04",20,381,401
"243","compass","2012-05",24,401,425
"244","compass","2012-06",31,425,456
"245","compass","2012-07",12,456,468
"246","compass","2012-08",20,467,487
"247","compass","2012-09",31,487,518
"248","compass","2012-10",26,518,544
"249","compass","2012-11",17,544,561
"250","compass","2012-12",8,562,570
"251","cookbooks","2012-03",748,11,759
"252","cookbooks","2012-04",763,11,774
"253","cookbooks","2012-05",780,11,791
"254","cookbooks","2012-06",786,11,797
"255","cookbooks","2012-07",785,11,796
"256","cookbooks","2012-08",790,11,801
"257","cookbooks","2012-09",803,12,815
"258","cookbooks","2012-10",796,15,811
"259","cookbooks","2012-11",795,18,813
"260","cookbooks","2012-12",798,18,816
"261","cucumber","2012-03",10,405,415
"262","cucumber","2012-04",5,415,420
"263","cucumber","2012-05",12,418,430
"264","cucumber","2012-06",16,430,446
"265","cucumber","2012-07",20,446,466
"266","cucumber","2012-08",21,466,487
"267","cucumber","2012-09",15,487,502
"268","cucumber","2012-10",28,502,530
"269","cucumber","2012-11",13,530,543
"270","cucumber","2012-12",15,543,558
"271","d3","2012-03",47,466,513
"272","d3","2012-04",87,513,600
"273","d3","2012-05",115,600,715
"274","d3","2012-06",114,715,829
"275","d3","2012-07",123,828,951
"276","d3","2012-08",151,950,1101
"277","d3","2012-09",132,1101,1233
"278","d3","2012-10",156,1233,1389
"279","d3","2012-11",208,1389,1597
"280","d3","2012-12",86,1597,1683
"281","devise","2012-03",34,697,731
"282","devise","2012-04",22,731,753
"283","devise","2012-05",55,752,807
"284","devise","2012-06",51,807,858
"285","devise","2012-07",41,856,897
"286","devise","2012-08",59,895,954
"287","devise","2012-09",56,954,1010
"288","devise","2012-10",70,1011,1081
"289","devise","2012-11",41,1082,1123
"290","devise","2012-12",49,1123,1172
"291","diaspora","2012-03",20,1280,1300
"292","diaspora","2012-04",32,1300,1332
"293","diaspora","2012-05",43,1331,1374
"294","diaspora","2012-06",38,1374,1412
"295","diaspora","2012-07",35,1411,1446
"296","diaspora","2012-08",78,1445,1523
"297","diaspora","2012-09",45,1523,1568
"298","diaspora","2012-10",54,1568,1622
"299","diaspora","2012-11",46,1622,1668
"300","diaspora","2012-12",21,1668,1689
"301","django","2012-03",37,704,741
"302","django","2012-04",772,11,783
"303","django","2012-05",148,132,280
"304","django","2012-06",166,280,446
"305","django","2012-07",170,446,616
"306","django","2012-08",170,616,786
"307","django","2012-09",152,786,938
"308","django","2012-10",148,938,1086
"309","django","2012-11",181,1086,1267
"310","django","2012-12",68,1267,1335
"311","django-cms","2012-03",4,465,469
"312","django-cms","2012-04",17,469,486
"313","django-cms","2012-05",24,486,510
"314","django-cms","2012-06",11,510,521
"315","django-cms","2012-07",14,521,535
"316","django-cms","2012-08",15,535,550
"317","django-cms","2012-09",10,550,560
"318","django-cms","2012-10",17,560,577
"319","django-cms","2012-11",13,575,588
"320","django-cms","2012-12",9,589,598
"321","doom3.gpl","2012-03",434,11,445
"322","doom3.gpl","2012-04",5,444,449
"323","doom3.gpl","2012-05",443,12,455
"324","doom3.gpl","2012-06",510,13,523
"325","doom3.gpl","2012-07",528,15,543
"326","doom3.gpl","2012-08",13,542,555
"327","doom3.gpl","2012-09",18,551,569
"328","doom3.gpl","2012-10",8,569,577
"329","doom3.gpl","2012-11",23,578,601
"330","doom3.gpl","2012-12",4,601,605
"331","dotfiles","2012-03",480,11,491
"332","dotfiles","2012-04",500,11,511
"333","dotfiles","2012-05",509,11,520
"334","dotfiles","2012-06",546,11,557
"335","dotfiles","2012-07",755,11,766
"336","dotfiles","2012-08",859,11,870
"337","dotfiles","2012-09",970,11,981
"338","dotfiles","2012-10",1067,11,1078
"339","dotfiles","2012-11",1181,11,1192
"340","dotfiles","2012-12",1257,12,1269
"341","emacs-starter-kit","2012-03",832,12,844
"342","emacs-starter-kit","2012-04",832,13,845
"343","emacs-starter-kit","2012-05",847,14,861
"344","emacs-starter-kit","2012-06",846,14,860
"345","emacs-starter-kit","2012-07",850,14,864
"346","emacs-starter-kit","2012-08",848,14,862
"347","emacs-starter-kit","2012-09",849,14,863
"348","emacs-starter-kit","2012-10",855,16,871
"349","emacs-starter-kit","2012-11",863,14,877
"350","emacs-starter-kit","2012-12",868,13,881
"351","express","2012-03",29,521,550
"352","express","2012-04",52,551,603
"353","express","2012-05",42,603,645
"354","express","2012-06",47,645,692
"355","express","2012-07",50,692,742
"356","express","2012-08",65,742,807
"357","express","2012-09",47,807,854
"358","express","2012-10",79,851,930
"359","express","2012-11",67,930,997
"360","express","2012-12",44,997,1041
"361","facebook-android-sdk","2012-03",26,362,388
"362","facebook-android-sdk","2012-04",39,388,427
"363","facebook-android-sdk","2012-05",55,428,483
"364","facebook-android-sdk","2012-06",46,483,529
"365","facebook-android-sdk","2012-07",64,528,592
"366","facebook-android-sdk","2012-08",71,592,663
"367","facebook-android-sdk","2012-09",53,663,716
"368","facebook-android-sdk","2012-10",47,716,763
"369","facebook-android-sdk","2012-11",65,764,829
"370","facebook-android-sdk","2012-12",30,829,859
"371","facebook-ios-sdk","2012-03",47,532,579
"372","facebook-ios-sdk","2012-04",58,579,637
"373","facebook-ios-sdk","2012-05",48,638,686
"374","facebook-ios-sdk","2012-06",75,685,760
"375","facebook-ios-sdk","2012-07",71,760,831
"376","facebook-ios-sdk","2012-08",69,832,901
"377","facebook-ios-sdk","2012-09",66,901,967
"378","facebook-ios-sdk","2012-10",67,967,1034
"379","facebook-ios-sdk","2012-11",50,1034,1084
"380","facebook-ios-sdk","2012-12",21,1084,1105
"381","fog","2012-03",13,383,396
"382","fog","2012-04",27,397,424
"383","fog","2012-05",23,423,446
"384","fog","2012-06",29,446,475
"385","fog","2012-07",27,475,502
"386","fog","2012-08",27,502,529
"387","fog","2012-09",34,530,564
"388","fog","2012-10",28,564,592
"389","fog","2012-11",36,592,628
"390","fog","2012-12",17,629,646
"391","formtastic","2012-03",4,398,402
"392","formtastic","2012-04",4,402,406
"393","formtastic","2012-05",8,405,413
"394","formtastic","2012-06",4,412,416
"395","formtastic","2012-07",10,414,424
"396","formtastic","2012-08",4,422,426
"397","formtastic","2012-09",4,425,429
"398","formtastic","2012-10",2,429,431
"399","formtastic","2012-11",6,430,436
"400","formtastic","2012-12",13,436,449
"401","foundation","2012-03",19,364,383
"402","foundation","2012-04",51,383,434
"403","foundation","2012-05",38,433,471
"404","foundation","2012-06",75,470,545
"405","foundation","2012-07",110,545,655
"406","foundation","2012-08",107,655,762
"407","foundation","2012-09",96,763,859
"408","foundation","2012-10",140,855,995
"409","foundation","2012-11",123,995,1118
"410","foundation","2012-12",1158,11,1169
"411","git","2012-03",428,11,439
"412","git","2012-04",467,16,483
"413","git","2012-05",544,11,555
"414","git","2012-06",611,12,623
"415","git","2012-07",677,16,693
"416","git","2012-08",746,17,763
"417","git","2012-09",800,18,818
"418","git","2012-10",882,21,903
"419","git","2012-11",958,27,985
"420","git","2012-12",996,33,1029
"421","github-services","2012-03",13,461,474
"422","github-services","2012-04",463,48,511
"423","github-services","2012-05",17,511,528
"424","github-services","2012-06",15,526,541
"425","github-services","2012-07",508,48,556
"426","github-services","2012-08",17,557,574
"427","github-services","2012-09",18,572,590
"428","github-services","2012-10",575,44,619
"429","github-services","2012-11",587,45,632
"430","github-services","2012-12",5,632,637
"431","gitignore","2012-03",34,574,608
"432","gitignore","2012-04",108,608,716
"433","gitignore","2012-05",71,716,787
"434","gitignore","2012-06",100,787,887
"435","gitignore","2012-07",94,887,981
"436","gitignore","2012-08",117,981,1098
"437","gitignore","2012-09",105,1098,1203
"438","gitignore","2012-10",126,1203,1329
"439","gitignore","2012-11",143,1329,1472
"440","gitignore","2012-12",54,1471,1525
"441","homebrew","2012-03",90,3633,3723
"442","homebrew","2012-04",142,3720,3862
"443","homebrew","2012-05",151,3861,4012
"444","homebrew","2012-06",146,4012,4158
"445","homebrew","2012-07",164,4159,4323
"446","homebrew","2012-08",208,4323,4531
"447","homebrew","2012-09",4695,11,4706
"448","homebrew","2012-10",4838,11,4849
"449","homebrew","2012-11",4982,18,5000
"450","homebrew","2012-12",5052,19,5071
"451","html5-boilerplate","2012-03",56,1655,1711
"452","html5-boilerplate","2012-04",126,1710,1836
"453","html5-boilerplate","2012-05",113,1836,1949
"454","html5-boilerplate","2012-06",178,1949,2127
"455","html5-boilerplate","2012-07",2234,11,2245
"456","html5-boilerplate","2012-08",2488,12,2500
"457","html5-boilerplate","2012-09",2746,15,2761
"458","html5-boilerplate","2012-10",2989,15,3004
"459","html5-boilerplate","2012-11",3197,16,3213
"460","html5-boilerplate","2012-12",3293,16,3309
"461","html5demos","2012-03",12,440,452
"462","html5demos","2012-04",481,11,492
"463","html5demos","2012-05",514,14,528
"464","html5demos","2012-06",538,17,555
"465","html5demos","2012-07",563,18,581
"466","html5demos","2012-08",614,18,632
"467","html5demos","2012-09",641,18,659
"468","html5demos","2012-10",675,19,694
"469","html5demos","2012-11",717,20,737
"470","html5demos","2012-12",731,25,756
"471","hubot","2012-03",399,16,415
"472","hubot","2012-04",410,14,424
"473","hubot","2012-05",30,424,454
"474","hubot","2012-06",461,15,476
"475","hubot","2012-07",479,16,495
"476","hubot","2012-08",507,16,523
"477","hubot","2012-09",530,16,546
"478","hubot","2012-10",558,17,575
"479","hubot","2012-11",23,574,597
"480","hubot","2012-12",16,597,613
"481","hw3_rottenpotatoes","2012-03",840,34,874
"482","hw3_rottenpotatoes","2012-04",30,873,903
"483","hw3_rottenpotatoes","2012-05",5,900,905
"484","hw3_rottenpotatoes","2012-06",227,926,1153
"485","hw3_rottenpotatoes","2012-07",8,1149,1157
"486","hw3_rottenpotatoes","2012-08",509,1150,1659
"487","hw3_rottenpotatoes","2012-09",80,1656,1736
"488","hw3_rottenpotatoes","2012-10",1131,1715,2846
"489","hw3_rottenpotatoes","2012-11",76,2847,2923
"490","hw3_rottenpotatoes","2012-12",7,2900,2907
"491","hw4_rottenpotatoes","2012-03",443,27,470
"492","hw4_rottenpotatoes","2012-04",67,469,536
"493","hw4_rottenpotatoes","2012-05",2,534,536
"494","hw4_rottenpotatoes","2012-06",156,539,695
"495","hw4_rottenpotatoes","2012-07",12,693,705
"496","hw4_rottenpotatoes","2012-08",253,703,956
"497","hw4_rottenpotatoes","2012-09",4,948,952
"498","hw4_rottenpotatoes","2012-10",422,952,1374
"499","hw4_rottenpotatoes","2012-11",547,1375,1922
"500","hw4_rottenpotatoes","2012-12",5,1901,1906
"501","impress.js","2012-03",80,1057,1137
"502","impress.js","2012-04",124,1137,1261
"503","impress.js","2012-05",85,1261,1346
"504","impress.js","2012-06",124,1346,1470
"505","impress.js","2012-07",110,1468,1578
"506","impress.js","2012-08",121,1578,1699
"507","impress.js","2012-09",156,1700,1856
"508","impress.js","2012-10",130,1856,1986
"509","impress.js","2012-11",123,1986,2109
"510","impress.js","2012-12",57,2108,2165
"511","jQTouch","2012-03",392,14,406
"512","jQTouch","2012-04",411,14,425
"513","jQTouch","2012-05",424,15,439
"514","jQTouch","2012-06",442,16,458
"515","jQTouch","2012-07",445,16,461
"516","jQTouch","2012-08",429,38,467
"517","jQTouch","2012-09",444,38,482
"518","jQTouch","2012-10",472,16,488
"519","jQTouch","2012-11",487,16,503
"520","jQTouch","2012-12",493,16,509
"521","janus","2012-03",7,525,532
"522","janus","2012-04",5,530,535
"523","janus","2012-05",10,526,536
"524","janus","2012-06",8,528,536
"525","janus","2012-07",4,535,539
"526","janus","2012-08",6,534,540
"527","janus","2012-09",8,530,538
"528","janus","2012-10",7,524,531
"529","janus","2012-11",8,527,535
"530","janus","2012-12",7,529,536
"531","jboss-as","2012-03",10,398,408
"532","jboss-as","2012-04",35,409,444
"533","jboss-as","2012-05",14,444,458
"534","jboss-as","2012-06",28,458,486
"535","jboss-as","2012-07",19,486,505
"536","jboss-as","2012-08",32,504,536
"537","jboss-as","2012-09",19,535,554
"538","jboss-as","2012-10",19,553,572
"539","jboss-as","2012-11",36,572,608
"540","jboss-as","2012-12",9,608,617
"541","jekyll","2012-03",842,34,876
"542","jekyll","2012-04",889,34,923
"543","jekyll","2012-05",936,34,970
"544","jekyll","2012-06",59,969,1028
"545","jekyll","2012-07",1060,30,1090
"546","jekyll","2012-08",59,1090,1149
"547","jekyll","2012-09",1167,30,1197
"548","jekyll","2012-10",1214,30,1244
"549","jekyll","2012-11",73,1244,1317
"550","jekyll","2012-12",41,1316,1357
"551","jenkins","2012-03",14,375,389
"552","jenkins","2012-04",34,390,424
"553","jenkins","2012-05",26,424,450
"554","jenkins","2012-06",24,450,474
"555","jenkins","2012-07",27,475,502
"556","jenkins","2012-08",25,503,528
"557","jenkins","2012-09",31,528,559
"558","jenkins","2012-10",42,558,600
"559","jenkins","2012-11",36,600,636
"560","jenkins","2012-12",24,637,661
"561","jquery","2012-03",66,1446,1512
"562","jquery","2012-04",108,1512,1620
"563","jquery","2012-05",110,1620,1730
"564","jquery","2012-06",138,1730,1868
"565","jquery","2012-07",119,1868,1987
"566","jquery","2012-08",154,1987,2141
"567","jquery","2012-09",177,2142,2319
"568","jquery","2012-10",171,2318,2489
"569","jquery","2012-11",181,2489,2670
"570","jquery","2012-12",68,2670,2738
"571","jquery-mobile","2012-03",1019,49,1068
"572","jquery-mobile","2012-04",1079,51,1130
"573","jquery-mobile","2012-05",1134,52,1186
"574","jquery-mobile","2012-06",1200,55,1255
"575","jquery-mobile","2012-07",1249,62,1311
"576","jquery-mobile","2012-08",1307,68,1375
"577","jquery-mobile","2012-09",1365,73,1438
"578","jquery-mobile","2012-10",66,1438,1504
"579","jquery-mobile","2012-11",56,1505,1561
"580","jquery-mobile","2012-12",24,1560,1584
"581","jquery-ui","2012-03",1181,77,1258
"582","jquery-ui","2012-04",1245,80,1325
"583","jquery-ui","2012-05",1303,83,1386
"584","jquery-ui","2012-06",1354,87,1441
"585","jquery-ui","2012-07",1407,90,1497
"586","jquery-ui","2012-08",1475,96,1571
"587","jquery-ui","2012-09",1533,107,1640
"588","jquery-ui","2012-10",1631,114,1745
"589","jquery-ui","2012-11",1719,123,1842
"590","jquery-ui","2012-12",1767,127,1894
"591","khan-exercises","2012-03",36,400,436
"592","khan-exercises","2012-04",22,436,458
"593","khan-exercises","2012-05",24,457,481
"594","khan-exercises","2012-06",28,481,509
"595","khan-exercises","2012-07",24,509,533
"596","khan-exercises","2012-08",23,533,556
"597","khan-exercises","2012-09",24,556,580
"598","khan-exercises","2012-10",27,580,607
"599","khan-exercises","2012-11",24,607,631
"600","khan-exercises","2012-12",15,630,645
"601","less.js","2012-03",58,608,666
"602","less.js","2012-04",39,665,704
"603","less.js","2012-05",59,702,761
"604","less.js","2012-06",66,761,827
"605","less.js","2012-07",54,827,881
"606","less.js","2012-08",70,881,951
"607","less.js","2012-09",36,951,987
"608","less.js","2012-10",76,985,1061
"609","less.js","2012-11",108,1061,1169
"610","less.js","2012-12",35,1168,1203
"611","linux","2012-03",632,26,658
"612","linux","2012-04",704,28,732
"613","linux","2012-05",792,38,830
"614","linux","2012-06",878,50,928
"615","linux","2012-07",1022,11,1033
"616","linux","2012-08",1141,13,1154
"617","linux","2012-09",1259,14,1273
"618","linux","2012-10",1398,11,1409
"619","linux","2012-11",1532,11,1543
"620","linux","2012-12",1600,14,1614
"621","linux-2.6","2012-03",1,500,501
"622","linux-2.6","2012-04",4,500,504
"623","linux-2.6","2012-05",3,502,505
"624","linux-2.6","2012-06",6,503,509
"625","linux-2.6","2012-07",10,501,511
"626","linux-2.6","2012-08",5,499,504
"627","linux-2.6","2012-09",5,501,506
"628","linux-2.6","2012-10",3,503,506
"629","linux-2.6","2012-11",2,506,508
"630","linux-2.6","2012-12",2,507,509
"631","mangos","2012-03",947,21,968
"632","mangos","2012-04",924,53,977
"633","mangos","2012-05",973,11,984
"634","mangos","2012-06",978,11,989
"635","mangos","2012-07",982,11,993
"636","mangos","2012-08",995,11,1006
"637","mangos","2012-09",50,11,61
"638","mangos","2012-10",50,11,61
"639","mangos","2012-11",52,11,63
"640","mangos","2012-12",53,12,65
"641","mongoid","2012-03",14,582,596
"642","mongoid","2012-04",10,595,605
"643","mongoid","2012-05",29,602,631
"644","mongoid","2012-06",24,631,655
"645","mongoid","2012-07",12,655,667
"646","mongoid","2012-08",22,667,689
"647","mongoid","2012-09",19,689,708
"648","mongoid","2012-10",20,709,729
"649","mongoid","2012-11",20,729,749
"650","mongoid","2012-12",9,749,758
"651","node","2012-03",63,1567,1630
"652","node","2012-04",91,1630,1721
"653","node","2012-05",143,1721,1864
"654","node","2012-06",155,1863,2018
"655","node","2012-07",180,2018,2198
"656","node","2012-08",166,2198,2364
"657","node","2012-09",155,2365,2520
"658","node","2012-10",161,2517,2678
"659","node","2012-11",199,2676,2875
"660","node","2012-12",83,2875,2958
"661","octopress","2012-03",65,653,718
"662","octopress","2012-04",71,717,788
"663","octopress","2012-05",70,789,859
"664","octopress","2012-06",85,858,943
"665","octopress","2012-07",95,943,1038
"666","octopress","2012-08",90,1036,1126
"667","octopress","2012-09",107,1127,1234
"668","octopress","2012-10",1303,11,1314
"669","octopress","2012-11",1392,11,1403
"670","octopress","2012-12",1430,12,1442
"671","oh-my-zsh","2012-03",1842,36,1878
"672","oh-my-zsh","2012-04",1932,45,1977
"673","oh-my-zsh","2012-05",2046,51,2097
"674","oh-my-zsh","2012-06",2214,11,2225
"675","oh-my-zsh","2012-07",2346,12,2358
"676","oh-my-zsh","2012-08",2480,12,2492
"677","oh-my-zsh","2012-09",2599,15,2614
"678","oh-my-zsh","2012-10",2757,15,2772
"679","oh-my-zsh","2012-11",2888,18,2906
"680","oh-my-zsh","2012-12",2993,20,3013
"681","omniauth","2012-03",5,441,446
"682","omniauth","2012-04",3,446,449
"683","omniauth","2012-05",7,447,454
"684","omniauth","2012-06",9,454,463
"685","omniauth","2012-07",6,462,468
"686","omniauth","2012-08",8,466,474
"687","omniauth","2012-09",3,472,475
"688","omniauth","2012-10",8,475,483
"689","omniauth","2012-11",6,483,489
"690","omniauth","2012-12",4,489,493
"691","paperclip","2012-03",784,21,805
"692","paperclip","2012-04",821,15,836
"693","paperclip","2012-05",838,21,859
"694","paperclip","2012-06",869,21,890
"695","paperclip","2012-07",902,16,918
"696","paperclip","2012-08",24,918,942
"697","paperclip","2012-09",16,940,956
"698","paperclip","2012-10",963,18,981
"699","paperclip","2012-11",961,23,984
"700","paperclip","2012-12",8,984,992
"701","phonegap-plugins","2012-03",149,246,395
"702","phonegap-plugins","2012-04",190,288,478
"703","phonegap-plugins","2012-05",238,355,593
"704","phonegap-plugins","2012-06",681,11,692
"705","phonegap-plugins","2012-07",792,11,803
"706","phonegap-plugins","2012-08",920,13,933
"707","phonegap-plugins","2012-09",1054,11,1065
"708","phonegap-plugins","2012-10",1216,13,1229
"709","phonegap-plugins","2012-11",1336,13,1349
"710","phonegap-plugins","2012-12",377,1054,1431
"711","phonegap-start","2012-03",822,16,838
"712","phonegap-start","2012-04",962,18,980
"713","phonegap-start","2012-05",1155,19,1174
"714","phonegap-start","2012-06",1332,21,1353
"715","phonegap-start","2012-07",1518,23,1541
"716","phonegap-start","2012-08",1780,25,1805
"717","phonegap-start","2012-09",1931,24,1955
"718","phonegap-start","2012-10",2074,28,2102
"719","phonegap-start","2012-11",2231,30,2261
"720","phonegap-start","2012-12",2304,33,2337
"721","php-sdk","2012-03",33,791,824
"722","php-sdk","2012-04",30,824,854
"723","php-sdk","2012-05",44,855,899
"724","php-sdk","2012-06",48,899,947
"725","php-sdk","2012-07",37,948,985
"726","php-sdk","2012-08",4,981,985
"727","php-sdk","2012-09",6,983,989
"728","php-sdk","2012-10",8,982,990
"729","php-sdk","2012-11",3,987,990
"730","php-sdk","2012-12",27,989,1016
"731","play","2012-03",310,72,382
"732","play","2012-04",313,82,395
"733","play","2012-05",310,94,404
"734","play","2012-06",307,99,406
"735","play","2012-07",307,103,410
"736","play","2012-08",307,111,418
"737","play","2012-09",315,116,431
"738","play","2012-10",320,120,440
"739","play","2012-11",318,126,444
"740","play","2012-12",311,136,447
"741","progit","2012-03",655,11,666
"742","progit","2012-04",691,11,702
"743","progit","2012-05",725,11,736
"744","progit","2012-06",767,12,779
"745","progit","2012-07",792,14,806
"746","progit","2012-08",823,16,839
"747","progit","2012-09",871,13,884
"748","progit","2012-10",907,14,921
"749","progit","2012-11",947,14,961
"750","progit","2012-12",964,19,983
"751","rails","2012-03",114,2859,2973
"752","rails","2012-04",140,2972,3112
"753","rails","2012-05",141,3112,3253
"754","rails","2012-06",205,3253,3458
"755","rails","2012-07",157,3459,3616
"756","rails","2012-08",172,3615,3787
"757","rails","2012-09",180,3784,3964
"758","rails","2012-10",199,3964,4163
"759","rails","2012-11",151,4161,4312
"760","rails","2012-12",108,4312,4420
"761","rails_admin","2012-03",25,576,601
"762","rails_admin","2012-04",595,13,608
"763","rails_admin","2012-05",29,608,637
"764","rails_admin","2012-06",16,637,653
"765","rails_admin","2012-07",660,13,673
"766","rails_admin","2012-08",19,673,692
"767","rails_admin","2012-09",22,692,714
"768","rails_admin","2012-10",34,714,748
"769","rails_admin","2012-11",26,748,774
"770","rails_admin","2012-12",30,773,803
"771","reddit","2012-03",34,372,406
"772","reddit","2012-04",21,406,427
"773","reddit","2012-05",30,425,455
"774","reddit","2012-06",34,453,487
"775","reddit","2012-07",34,486,520
"776","reddit","2012-08",46,520,566
"777","reddit","2012-09",29,564,593
"778","reddit","2012-10",17,592,609
"779","reddit","2012-11",39,608,647
"780","reddit","2012-12",16,647,663
"781","redis","2012-03",544,11,555
"782","redis","2012-04",605,11,616
"783","redis","2012-05",641,11,652
"784","redis","2012-06",695,13,708
"785","redis","2012-07",740,14,754
"786","redis","2012-08",784,15,799
"787","redis","2012-09",831,16,847
"788","redis","2012-10",900,17,917
"789","redis","2012-11",973,19,992
"790","redis","2012-12",1018,21,1039
"791","redmine","2012-03",615,11,626
"792","redmine","2012-04",612,15,627
"793","redmine","2012-05",597,40,637
"794","redmine","2012-06",559,82,641
"795","redmine","2012-07",535,109,644
"796","redmine","2012-08",509,130,639
"797","redmine","2012-09",477,158,635
"798","redmine","2012-10",459,180,639
"799","redmine","2012-11",635,11,646
"800","redmine","2012-12",644,11,655
"801","refinerycms","2012-03",25,602,627
"802","refinerycms","2012-04",35,627,662
"803","refinerycms","2012-05",24,662,686
"804","refinerycms","2012-06",17,687,704
"805","refinerycms","2012-07",22,702,724
"806","refinerycms","2012-08",11,724,735
"807","refinerycms","2012-09",36,729,765
"808","refinerycms","2012-10",16,764,780
"809","refinerycms","2012-11",27,780,807
"810","refinerycms","2012-12",14,806,820
"811","resque","2012-03",17,509,526
"812","resque","2012-04",19,526,545
"813","resque","2012-05",37,545,582
"814","resque","2012-06",52,582,634
"815","resque","2012-07",26,634,660
"816","resque","2012-08",29,660,689
"817","resque","2012-09",63,689,752
"818","resque","2012-10",32,752,784
"819","resque","2012-11",25,783,808
"820","resque","2012-12",12,808,820
"821","ruby","2012-03",15,434,449
"822","ruby","2012-04",442,24,466
"823","ruby","2012-05",469,24,493
"824","ruby","2012-06",485,25,510
"825","ruby","2012-07",517,25,542
"826","ruby","2012-08",563,11,574
"827","ruby","2012-09",583,11,594
"828","ruby","2012-10",614,26,640
"829","ruby","2012-11",662,12,674
"830","ruby","2012-12",684,13,697
"831","rvm","2012-03",11,379,390
"832","rvm","2012-04",14,388,402
"833","rvm","2012-05",12,402,414
"834","rvm","2012-06",10,411,421
"835","rvm","2012-07",8,420,428
"836","rvm","2012-08",11,425,436
"837","rvm","2012-09",4,434,438
"838","rvm","2012-10",10,434,444
"839","rvm","2012-11",14,444,458
"840","rvm","2012-12",10,458,468
"841","scriptaculous","2012-03",1,428,429
"842","scriptaculous","2012-04",3,428,431
"843","scriptaculous","2012-05",3,430,433
"844","scriptaculous","2012-06",4,433,437
"845","scriptaculous","2012-07",2,437,439
"846","scriptaculous","2012-08",8,436,444
"847","scriptaculous","2012-09",6,443,449
"848","scriptaculous","2012-10",12,449,461
"849","scriptaculous","2012-11",9,461,470
"850","scriptaculous","2012-12",4,470,474
"851","sinatra","2012-03",86,406,492
"852","sinatra","2012-04",89,425,514
"853","sinatra","2012-05",89,443,532
"854","sinatra","2012-06",88,472,560
"855","sinatra","2012-07",102,494,596
"856","sinatra","2012-08",79,523,602
"857","sinatra","2012-09",77,529,606
"858","sinatra","2012-10",85,535,620
"859","sinatra","2012-11",103,556,659
"860","sinatra","2012-12",86,584,670
"861","snipmate.vim","2012-03",6,387,393
"862","snipmate.vim","2012-04",10,392,402
"863","snipmate.vim","2012-05",14,402,416
"864","snipmate.vim","2012-06",8,413,421
"865","snipmate.vim","2012-07",17,420,437
"866","snipmate.vim","2012-08",25,437,462
"867","snipmate.vim","2012-09",10,462,472
"868","snipmate.vim","2012-10",16,472,488
"869","snipmate.vim","2012-11",21,488,509
"870","snipmate.vim","2012-12",11,509,520
"871","socket.io","2012-03",19,457,476
"872","socket.io","2012-04",31,477,508
"873","socket.io","2012-05",57,508,565
"874","socket.io","2012-06",49,565,614
"875","socket.io","2012-07",58,613,671
"876","socket.io","2012-08",54,671,725
"877","socket.io","2012-09",49,726,775
"878","socket.io","2012-10",50,775,825
"879","socket.io","2012-11",59,825,884
"880","socket.io","2012-12",36,884,920
"881","spree","2012-03",24,799,823
"882","spree","2012-04",47,822,869
"883","spree","2012-05",45,869,914
"884","spree","2012-06",49,911,960
"885","spree","2012-07",45,960,1005
"886","spree","2012-08",54,1005,1059
"887","spree","2012-09",53,1059,1112
"888","spree","2012-10",51,1112,1163
"889","spree","2012-11",47,1163,1210
"890","spree","2012-12",19,1210,1229
"891","symfony","2012-03",1068,54,1122
"892","symfony","2012-04",1122,54,1176
"893","symfony","2012-05",1218,48,1266
"894","symfony","2012-06",1308,47,1355
"895","symfony","2012-07",1404,47,1451
"896","symfony","2012-08",1487,45,1532
"897","symfony","2012-09",1555,45,1600
"898","symfony","2012-10",1648,45,1693
"899","symfony","2012-11",1745,48,1793
"900","symfony","2012-12",1791,48,1839
"901","symfony-docs","2012-03",21,376,397
"902","symfony-docs","2012-04",20,397,417
"903","symfony-docs","2012-05",22,416,438
"904","symfony-docs","2012-06",18,438,456
"905","symfony-docs","2012-07",51,456,507
"906","symfony-docs","2012-08",22,508,530
"907","symfony-docs","2012-09",31,530,561
"908","symfony-docs","2012-10",39,561,600
"909","symfony-docs","2012-11",47,600,647
"910","symfony-docs","2012-12",9,647,656
"911","three.js","2012-03",46,616,662
"912","three.js","2012-04",56,662,718
"913","three.js","2012-05",87,718,805
"914","three.js","2012-06",80,805,885
"915","three.js","2012-07",69,885,954
"916","three.js","2012-08",86,955,1041
"917","three.js","2012-09",115,1042,1157
"918","three.js","2012-10",133,1157,1290
"919","three.js","2012-11",128,1290,1418
"920","three.js","2012-12",83,1418,1501
"921","three20","2012-03",27,904,931
"922","three20","2012-04",44,928,972
"923","three20","2012-05",29,972,1001
"924","three20","2012-06",43,1001,1044
"925","three20","2012-07",34,1043,1077
"926","three20","2012-08",40,1078,1118
"927","three20","2012-09",56,1117,1173
"928","three20","2012-10",44,1173,1217
"929","three20","2012-11",46,1217,1263
"930","three20","2012-12",21,1263,1284
"931","titanium_mobile","2012-03",21,383,404
"932","titanium_mobile","2012-04",25,404,429
"933","titanium_mobile","2012-05",12,429,441
"934","titanium_mobile","2012-06",20,441,461
"935","titanium_mobile","2012-07",15,462,477
"936","titanium_mobile","2012-08",13,477,490
"937","titanium_mobile","2012-09",498,11,509
"938","titanium_mobile","2012-10",15,510,525
"939","titanium_mobile","2012-11",5,524,529
"940","titanium_mobile","2012-12",13,529,542
"941","tornado","2012-03",16,581,597
"942","tornado","2012-04",28,594,622
"943","tornado","2012-05",30,622,652
"944","tornado","2012-06",41,650,691
"945","tornado","2012-07",40,690,730
"946","tornado","2012-08",28,728,756
"947","tornado","2012-09",44,756,800
"948","tornado","2012-10",45,800,845
"949","tornado","2012-11",53,843,896
"950","tornado","2012-12",22,896,918
"951","underscore","2012-03",40,410,450
"952","underscore","2012-04",486,11,497
"953","underscore","2012-05",534,12,546
"954","underscore","2012-06",577,18,595
"955","underscore","2012-07",626,24,650
"956","underscore","2012-08",681,26,707
"957","underscore","2012-09",728,33,761
"958","underscore","2012-10",777,38,815
"959","underscore","2012-11",829,43,872
"960","underscore","2012-12",864,48,912
"961","vimrc","2012-03",534,32,566
"962","vimrc","2012-04",536,32,568
"963","vimrc","2012-05",66,31,97
"964","vimrc","2012-06",551,11,562
"965","vimrc","2012-07",96,11,107
"966","vimrc","2012-08",105,11,116
"967","vimrc","2012-09",559,11,570
"968","vimrc","2012-10",553,11,564
"969","vimrc","2012-11",549,12,561
"970","vimrc","2012-12",110,45,155
"971","will_paginate","2012-03",10,423,433
"972","will_paginate","2012-04",8,432,440
"973","will_paginate","2012-05",13,440,453
"974","will_paginate","2012-06",6,453,459
"975","will_paginate","2012-07",9,459,468
"976","will_paginate","2012-08",11,467,478
"977","will_paginate","2012-09",11,478,489
"978","will_paginate","2012-10",5,490,495
"979","will_paginate","2012-11",14,495,509
"980","will_paginate","2012-12",1,511,512
"981","xbmc","2012-03",502,11,513
"982","xbmc","2012-04",533,11,544
"983","xbmc","2012-05",578,11,589
"984","xbmc","2012-06",622,12,634
"985","xbmc","2012-07",663,14,677
"986","xbmc","2012-08",715,14,729
"987","xbmc","2012-09",772,15,787
"988","xbmc","2012-10",847,11,858
"989","xbmc","2012-11",887,11,898
"990","xbmc","2012-12",907,11,918
"991","zf2","2012-03",27,727,754
"992","zf2","2012-04",52,752,804
"993","zf2","2012-05",60,804,864
"994","zf2","2012-06",64,865,929
"995","zf2","2012-07",60,929,989
"996","zf2","2012-08",68,988,1056
"997","zf2","2012-09",204,1056,1260
"998","zf2","2012-10",128,1260,1388
"999","zf2","2012-11",92,1388,1480
"1000","zf2","2012-12",56,1480,1536
